domain,domain_name,easy,medium,hard,total
d,Transcriptome Quantification and Annotation,1,17,16,34
e,Differential Expression,0,19,5,24
b,Read Alignment,0,12,10,22
g,Immune Repertoire Profiling and Cell Deconvolution,5,10,6,21
f,RNA Splicing,0,8,12,20
j,Fusion Detection,1,5,12,18
a,Data Quality Control,1,11,4,16
c,Transcriptome assembly ,0,3,13,16
k,Small RNA detection,10,0,4,14
l,Visualization Tools ,1,6,7,14
h,Allele Specific Expression ,0,5,6,11
i,Viral Detection ,0,2,2,4